    #                                                                                                                      *
    #                                                                                                                      *                                         *
    #                                                                                                                      *                                         *
    #                                                                                                                      *                                         *
    #                                                                                                                                                        F       *
####################################################################       ## ## ## ## ## ## ## ################################################################################
##########################################################################                       ########################                                                                                                                      
#############################################################################                         ###################
########****####################################################################                       #################
#####**      #######################################################################                      ##############
#****         ***********************######################################################                    ############
#                                  ############################################################                 #########
#                                  ##################################################################             #######
#       ################               ##################################################################         #######
##     #  ################                   #################################################################    #######                                                                                                                      
#         #################                       *                  *                                            #######
######    #################                                          *                                          #########
##       ##################                                          *                                         ##########                                                                                                                       
###     ###################                                                                                   ###########                                                                                                                     
###    ####################                                                                                  ############
##    #####################                                       *    *             **                    ##############                                                                                                                       
###  ###########################################  #######################################################################
##    ##########################################  #######################################################################                                                                                                                       
###  ##########################################   #######################################################################                                                                                                                       #
#    ##########                                                                                                    ######
#   ############                                                                                                    ######                                                                                                                     
#  #################                                                                                                    ######
# #################                                                                                                    ######
#  ##################                                                                                                    ######
## ###############                                                                                                    ######                                                                                                                   
#  ###################                                                                                                    ######
# #####################                                                                                                  #########
#  ###########################                                                                                       ######
## ###################### ########                                                                           ##########
#  ###################################                                                                   ##################
# ###################################                                                              ####################
#  #################################                                                              #########################
## ##########################                                                                        #####################                                                                                                                      
#  ####################
# #####################################################################         #########################################
#  ###################################################################                *##################################                                                                                                                     
## ###################################################################        ######   *#################################
#  ###################################################################        #######   *################################
# ####################################################################        #########  *###############################
#                                                                         ****#########   ###############################
 #######################################################################################  ###############################
#P                                                                                          *#############################
#########################################################################################################################