   *                                                                                                                     
   *                                                                *
   *                                                                *
   *                                                                *
   *                                 P                              #
#######################################################             #
                                                       *            *
                                                       *            * 
                                                        *            *
                                                         *            *  
                                                          *            * 
                                                            *            * 
                                                             *            * 
                                                             *             *
                                                             *            *  
                                                            *            * 
                                                          *            * 
                                                          *            * 
                                                            *            *
                                                              *            * 
                                                                *            *
                                                                  *            * 
                                                                   *            *
                                                                  *            * 
                                                                 *            *

                                                                                                                                   F
                                                                                                                                  ##

                                                                                                                              #
                                                                                                                          #

                                                                                                                            #

                                                                                        **       **      **      **           #
                                                                                 ##############################################


                                                      #############################



