##################################################################################################################################
#                                                                                                                                #
#                                                                                                                                # 
#                                                                                                                                # 
#                                                                                                                                # 
#                                                                                                                                # 
#                                                                                                                                # 
#                                                                                                                                # 
#                                                                                                                                # 
#                                                                                                                                # 
#                                                                                                                                # 
#                                                                                                                                # 
#                    P                                                                                                           # 
#                                                                                                                                # 
#                                                                                                                                # 
#                                                                                                                                # 
#                                                                                                                                # 
#                                                                                                                                # 
#                                                                                                                                # 
#                                                                                                                                # 
#                                                                                                                                # 
#                                                                                                                                # 
#                                                                                                                                # 
#                                                                                                                                # 
#                                                                                                                                # 
#                                                                                                                                # 
#                                                                                                                                # 
#                                                                                                                                # 
#                                                                                                                                #
##################################################################################################################################
