#                                                                                                #
#                                                                                                #
#                                                                                                #
#                                                                                                #
#                                                                  
#                                                F                                                #
#                                          ##########                                             #
#                                        #                                                        #
#                                       #                                                         #
#                                      ## *                                                         #
#                             ##  #  ##                                                              #
#       #   ##       ######### * ##                                                                     #
#            P                                                                                   #
#      ############                                                                                #
#                                                                                                #









             